1111111111111111111111111111111111111111
1000000000000000000000000000000000000001
1000000000000200200000000300000002222001
1400000222200100102000222222200000000001
1000000000100111101000100000000000000001
1000000000100000001000100002220000222221
1000002000111111111000122000012222000001
1000000000000000000000001000000000000001
1000222000030000000200001000030000000001
1020000022222222000000001222222222000001
1000000000000400000000000111111110000001
1000000000000000003000200000000000000401
1000020020002220222220120000000000000001
1020210010000000000000112000000000200001
1010010010000003000000111200030000120021
1010012210002222220220111111111111112011
1012000110000000000000000000000004000001
1001000112220000000000220000000000002221
1001000010000000020000012222220000000001
1000000010000000000000000000000200200001
1000002212222000000000000000000000000001
1000000000000000000020000300002002002001
1000030000000030000012222222000001000001
1002222200022222220010000000000001000001
1021000020000000000210000040000001000021
1000000000222220022110002222202001000001
1222220002000000011110010000000001002001
1000000000000022211110010202222221221201
1000000000000000300000010030000000000001
1111111111111111111111111111111111111111

